........W...W..............
.X....W...W...W...........R
####^^^^^^^^^^^^^^........W
.......W...W...W.........##
r....W...W...W...W.........
..^^^^^^^^^^^^^^^^##.......
....W...W...W..............
..W...W...W...W........W..R
##^^^^^^^^^^^^^^^^....##...
.......W...W...W...........
r....W...W...W...W..#......
..^^^^^^^^^^^^^^^^###......
...W...W...W...W....#....--
.W...W...W...W....1.#.W.W.W
#####################^^^^^^
Red tiles are hot and reduce the time before you explode.
Time =40
