...........................
..........X................
........#####.........-----
...........................
..C...W.W.W.W.W..C.........
###################------..
.W.........................
---.W...........W....--....
...........................
.S..W.....W......S.W.......
---.............----.......
...........................
......................-----
.1.....S.....W.............
###...###...###...###......
When Sparky drops down, better get out of the way.
Time =10
