.............................
r....W.......................
...@@@.......................
...S..........WWW........WWWR
...@@.........WWW########WWW.
..........1...WWW........WWW.
...@@....@@...WWW........WWW.
....W.........@@@........@@@.
............. WWW........WWWR
...@@.......--WWW...--...WWW.
..............WWW........WWW.
r...........--WWW...--...WWW.
..............WWW........WWW.
.X..A...T.....WWW........WWW.
######..###...@@@...@@...@@@.
There are many drops in the ocean...
Time =50
