....................
r..W.W.W.......W.W.W
@@@@@@@@............
.............---....
....................
........---.......X.
................----
........C...........
......-------.......
................W..R
...............++...
W..T..........W.....
+++++.........++....
.1..............W...
#######......@@@@@..
Use the turtle to jump higher, but watch out when it sneezes.
Time =10
