...........................
..........X............W.W.
........#####.........-----
...........................
......WCW.W.W.W..C.........
....###############----....
.W.........................
---.W...........W....--....
...........................
.S..W.....W......S.W.......
---.............----.......
........................W..
......................-----
.1.....S.....W.............
###...###...###...###......
When Sparky drops down, better get out of the way.
Time =45
